????????????????????
?                  ?
?                  ?
?###############   ?
?                  ?
?                  ?
?  ################?
?                  ?
?                  ?
?################  ?
?            ***   ?
?            ***   ?
?  ################?
?                  ?
?                  ?
?################  ?
?                  ?
?  ################?
?                  ?
????????????????????