####################
#                  #
#                  #
################   #
#                  #
#                  #
#  #################
#                  #
#                  #
#################  #
#                  #
#                  #
#  #################
#                  #
#                  #
#################  #
#                  #
#  #################
#                  #
####################