????????????????????
?             **   ?
?             **   ?
?  ############    ?
?       **   ##    ?
?           1      ?
?  ###             ?
?  ################?
?      *********** ?
?                  ?
?#####   ########  ?
? *###   ########  ?
? *###   ########  ?
? *###   ########  ?
? *###   ########  ?
? *###   ########  ?
? *###   ########  ?
?        ********  ?
?                  ?
????????????????????